1111111001111111
1000000000000001
1011101111011101
1000000000000001
1011011221101101
1010010000100101
1010111111110101
0000000000000000
0000000000000000
1011011111101101
1000000000000001
1000000000000001
1000000000000001
1000000000000001
1000000000000001
1111111001111111